A thing or object - 것
To do - 하다 (1)
To be - 있다
way, method - 수
To do - 하다 (2)
I - 나
without, absent - 없다
To not be/do - 않다
Person - 사람
we/our - 우리
He - 그
To not be - 아니다
To try - 보다 (1)
That thing - 거
To see - 보다 (2)
To be similar - 같다
To give/do for a person - 주다
To face/confront - 대하다
To go - 가다
Year - 년
One/single - 한
speech, language, words - 말
Work - 일 (1)
A man/woman - 이
To say - 말하다
To do for - 위하다
However - 그러나
To come - 오다
To know - 알다
Mr./Ms. - 씨
That is right - 그렇다
To be big/large - 크다
One day - 일 (2)
society, culture - 사회
many, much - 많다
not - 안
To be good - 좋다
More - 더
To receive - 받다
That thing - 그것
house, home - 집
To come out - 나오다
And then - 그리고
problem, question - 문제
Such a - 그런
To live - 살다
That - 저
To be impossible - 못하다
To think - 생각하다
To not know - 모르다